[[
[7, 7, 7, 7, 7, 7, 7, 7, 7, 7, 7, 7, 7, 7, 7, 7, 7, 7, 7, 7, 7, 7, 7, 7, 7], 
[7, 3, 3, 5, 5, 5, 5, 2, 5, 2, 5, 5, 5, 2, 5, 5, 5, 5, 2, 5, 5, 5, 3, 3, 7], 
[7, 3, 3, 3, 5, 5, 5, 2, 5, 2, 5, 2, 2, 2, 5, 2, 5, 5, 5, 5, 5, 3, 3, 3, 7], 
[7, 1, 3, 3, 3, 5, 2, 5, 5, 2, 5, 5, 2, 2, 2, 3, 2, 5, 5, 5, 3, 3, 3, 4, 7], 
[7, 1, 1, 3, 3, 3, 5, 5, 5, 5, 2, 5, 5, 2, 3, 3, 2, 5, 5, 3, 3, 3, 4, 4, 7], 
[7, 1, 1, 1, 3, 3, 3, 5, 2, 5, 2, 5, 5, 5, 5, 3, 3, 5, 3, 3, 3, 4, 4, 4, 7], 
[7, 1, 1, 1, 1, 3, 3, 3, 5, 5, 2, 5, 2, 5, 2, 5, 3, 3, 3, 3, 4, 4, 4, 4, 7], 
[7, 3, 1, 1, 1, 1, 3, 3, 3, 5, 5, 5, 5, 5, 5, 5, 3, 3, 3, 4, 4, 1, 4, 4, 7], 
[7, 1, 1, 1, 1, 1, 1, 3, 3, 3, 5, 5, 5, 5, 5, 3, 3, 3, 4, 4, 4, 4, 4, 4, 7], 
[7, 1, 3, 1, 1, 1, 1, 1, 3, 3, 3, 5, 5, 5, 3, 3, 3, 4, 4, 4, 4, 4, 4, 4, 7], 
[7, 1, 1, 1, 1, 1, 1, 1, 1, 3, 3, 3, 5, 3, 3, 3, 4, 4, 4, 4, 1, 3, 3, 2, 7], 
[7, 1, 1, 1, 3, 3, 1, 1, 1, 1, 3, 3, 3, 3, 3, 4, 4, 4, 1, 4, 3, 4, 2, 2, 7], 
[7, 1, 1, 1, 3, 3, 1, 1, 1, 1, 1, 3, 2, 3, 4, 4, 4, 4, 4, 4, 3, 4, 4, 2, 7], 
[7, 3, 1, 1, 1, 3, 1, 1, 1, 1, 3, 3, 3, 3, 3, 1, 4, 1, 4, 4, 3, 4, 4, 4, 7], 
[7, 1, 1, 1, 1, 1, 1, 1, 1, 3, 3, 3, 1, 3, 3, 3, 4, 4, 4, 3, 3, 3, 4, 4, 7], 
[7, 3, 1, 1, 1, 1, 1, 1, 3, 3, 3, 1, 1, 6, 3, 3, 3, 4, 4, 3, 3, 4, 4, 4, 7], 
[7, 1, 1, 1, 1, 1, 1, 3, 3, 3, 6, 6, 6, 6, 6, 3, 3, 3, 3, 3, 4, 4, 4, 4, 7], 
[7, 1, 1, 1, 1, 1, 3, 3, 3, 6, 6, 6, 6, 6, 6, 3, 3, 3, 3, 1, 4, 1, 4, 4, 7], 
[7, 1, 1, 1, 1, 3, 3, 3, 6, 6, 6, 7, 6, 6, 3, 3, 6, 3, 3, 3, 4, 4, 4, 4, 7], 
[7, 1, 1, 1, 3, 3, 3, 6, 6, 6, 6, 6, 6, 3, 3, 3, 6, 4, 3, 3, 3, 4, 4, 4, 7], 
[7, 1, 1, 3, 3, 3, 6, 6, 6, 6, 7, 6, 7, 3, 6, 7, 6, 4, 4, 3, 3, 3, 4, 4, 7], 
[7, 1, 3, 3, 3, 6, 6, 6, 6, 6, 6, 6, 2, 3, 6, 6, 6, 4, 4, 4, 3, 3, 3, 4, 7], 
[7, 3, 3, 3, 6, 6, 6, 6, 6, 1, 1, 6, 2, 2, 7, 6, 7, 6, 6, 4, 6, 3, 3, 3, 7], 
[7, 3, 3, 6, 6, 6, 6, 6, 6, 6, 7, 6, 7, 6, 6, 6, 6, 6, 7, 6, 6, 6, 3, 3, 7], 
[7, 7, 7, 7, 7, 7, 7, 7, 7, 7, 7, 7, 7, 7, 7, 7, 7, 7, 7, 7, 7, 7, 7, 7, 7] ],[]]