[[
[7, 7, 7, 7, 7, 7, 7, 7, 7, 7, 7, 7, 7, 7, 7, 7, 7, 7, 7, 7, 7, 7, 7, 7, 7], 
[7, 3, 3, 3, 3, 3, 3, 3, 3, 3, 3, 2, 2, 2, 3, 3, 3, 3, 3, 3, 3, 3, 3, 3, 7], 
[7, 3, 3, 3, 3, 3, 3, 3, 3, 3, 3, 2, 2, 3, 3, 3, 3, 3, 3, 3, 3, 3, 3, 3, 7], 
[7, 3, 3, 3, 3, 3, 3, 3, 3, 3, 3, 5, 2, 3, 3, 3, 3, 3, 3, 3, 3, 3, 3, 3, 7], 
[7, 3, 3, 3, 3, 3, 3, 3, 3, 3, 3, 5, 5, 3, 3, 3, 3, 3, 3, 3, 3, 3, 3, 3, 7], 
[7, 3, 3, 3, 3, 3, 3, 3, 3, 3, 3, 1, 5, 5, 3, 3, 3, 3, 3, 3, 3, 3, 3, 3, 7], 
[7, 3, 3, 3, 3, 3, 3, 3, 3, 3, 3, 4, 4, 1, 3, 3, 3, 3, 3, 3, 3, 3, 3, 3, 7], 
[7, 3, 3, 3, 3, 3, 3, 3, 3, 3, 3, 1, 4, 4, 3, 3, 3, 3, 3, 3, 3, 3, 3, 3, 7], 
[7, 3, 3, 3, 3, 3, 3, 3, 3, 3, 3, 3, 5, 5, 2, 3, 3, 3, 3, 3, 3, 3, 3, 3, 7], 
[7, 3, 3, 3, 3, 3, 3, 3, 3, 3, 3, 3, 5, 2, 2, 3, 3, 3, 3, 3, 3, 3, 3, 3, 7], 
[7, 3, 3, 3, 3, 3, 3, 3, 3, 3, 3, 3, 4, 5, 3, 3, 3, 3, 3, 3, 3, 3, 3, 3, 7], 
[7, 3, 3, 3, 3, 3, 3, 3, 3, 3, 3, 3, 1, 4, 3, 3, 3, 3, 3, 3, 3, 3, 3, 3, 7], 
[7, 3, 3, 3, 3, 3, 3, 3, 3, 3, 3, 1, 4, 4, 3, 3, 3, 3, 3, 3, 3, 3, 3, 3, 7], 
[7, 3, 3, 3, 3, 3, 3, 3, 3, 3, 3, 5, 2, 4, 3, 3, 3, 3, 3, 3, 3, 3, 3, 3, 7], 
[7, 3, 3, 3, 3, 3, 3, 3, 3, 3, 3, 1, 2, 5, 3, 3, 3, 3, 3, 3, 3, 3, 3, 3, 7], 
[7, 3, 3, 3, 3, 3, 3, 3, 3, 3, 3, 1, 2, 5, 3, 3, 3, 3, 3, 3, 3, 3, 3, 3, 7], 
[7, 3, 3, 3, 3, 3, 3, 3, 3, 3, 3, 4, 4, 1, 3, 3, 3, 3, 3, 3, 3, 3, 3, 3, 7], 
[7, 3, 3, 3, 3, 3, 3, 3, 3, 3, 3, 6, 4, 4, 3, 3, 3, 3, 3, 3, 3, 3, 3, 3, 7], 
[7, 3, 3, 3, 3, 3, 3, 3, 3, 3, 3, 6, 4, 1, 3, 3, 3, 3, 3, 3, 3, 3, 3, 3, 7], 
[7, 3, 3, 3, 3, 3, 3, 3, 3, 3, 3, 6, 4, 3, 3, 3, 3, 3, 3, 3, 3, 3, 3, 3, 7], 
[7, 3, 3, 3, 3, 3, 3, 3, 3, 3, 3, 4, 4, 3, 3, 3, 3, 3, 3, 3, 3, 3, 3, 3, 7], 
[7, 3, 3, 3, 3, 3, 3, 3, 3, 3, 3, 4, 5, 3, 3, 3, 3, 3, 3, 3, 3, 3, 3, 3, 7], 
[7, 3, 3, 3, 3, 3, 3, 3, 3, 3, 3, 5, 2, 2, 3, 3, 3, 3, 3, 3, 3, 3, 3, 3, 7], 
[7, 3, 3, 3, 3, 3, 3, 3, 3, 3, 3, 3, 2, 2, 3, 3, 3, 3, 3, 3, 3, 3, 3, 3, 7], 
[7, 7, 7, 7, 7, 7, 7, 7, 7, 7, 7, 7, 7, 7, 7, 7, 7, 7, 7, 7, 7, 7, 7, 7, 7] ],[]]