[[
[7, 7, 7, 7, 7, 7, 7, 7, 7, 7, 7, 7, 7, 7, 7, 7, 7, 7, 7, 7, 7, 7, 7, 7, 7], 
[7, 4, 5, 5, 5, 5, 5, 5, 5, 5, 5, 5, 5, 4, 5, 5, 5, 5, 5, 5, 5, 5, 4, 4, 7], 
[7, 5, 5, 5, 5, 5, 5, 5, 5, 5, 5, 5, 1, 4, 4, 5, 5, 4, 5, 5, 5, 4, 4, 4, 7], 
[7, 5, 5, 5, 5, 5, 5, 5, 5, 1, 5, 5, 1, 4, 4, 4, 5, 5, 5, 5, 5, 5, 4, 4, 7], 
[7, 5, 5, 5, 5, 5, 5, 5, 5, 1, 5, 5, 1, 5, 5, 5, 5, 4, 5, 5, 5, 5, 5, 4, 7], 
[7, 5, 5, 5, 5, 4, 5, 5, 1, 1, 5, 5, 2, 4, 5, 5, 5, 5, 5, 5, 5, 5, 5, 5, 7], 
[7, 5, 5, 5, 5, 5, 5, 5, 5, 1, 2, 5, 2, 2, 2, 5, 4, 5, 5, 4, 4, 5, 5, 5, 7], 
[7, 5, 5, 5, 5, 5, 5, 5, 5, 2, 2, 2, 2, 3, 5, 5, 5, 5, 5, 5, 5, 5, 4, 5, 7], 
[7, 5, 5, 5, 5, 4, 5, 5, 2, 2, 2, 3, 3, 3, 5, 5, 5, 5, 4, 5, 5, 4, 5, 5, 7], 
[7, 5, 5, 4, 5, 5, 5, 2, 2, 2, 2, 3, 3, 3, 3, 5, 5, 5, 5, 5, 4, 5, 5, 4, 7], 
[7, 5, 5, 5, 5, 5, 5, 5, 2, 2, 3, 3, 3, 3, 3, 3, 3, 5, 5, 5, 5, 5, 5, 5, 7], 
[7, 5, 5, 5, 5, 5, 5, 5, 2, 2, 2, 3, 3, 5, 3, 3, 3, 3, 2, 2, 5, 5, 4, 5, 7], 
[7, 5, 5, 5, 5, 5, 5, 5, 5, 2, 2, 2, 2, 5, 1, 5, 3, 3, 3, 3, 5, 5, 5, 5, 7], 
[7, 5, 5, 4, 5, 5, 5, 5, 4, 5, 5, 2, 1, 1, 5, 5, 5, 3, 3, 3, 3, 2, 2, 5, 7], 
[7, 5, 5, 5, 5, 5, 5, 5, 5, 5, 5, 5, 5, 5, 5, 5, 5, 5, 3, 3, 3, 3, 2, 5, 7], 
[7, 5, 5, 5, 5, 5, 5, 5, 5, 5, 5, 5, 5, 5, 5, 5, 5, 5, 2, 3, 3, 3, 2, 2, 7], 
[7, 5, 5, 5, 5, 4, 5, 5, 5, 5, 4, 5, 5, 4, 5, 5, 5, 5, 3, 3, 3, 2, 2, 4, 7], 
[7, 5, 5, 5, 5, 5, 5, 5, 5, 5, 5, 5, 5, 5, 5, 5, 5, 3, 3, 3, 5, 5, 2, 4, 7], 
[7, 5, 5, 5, 5, 5, 5, 5, 4, 5, 5, 5, 5, 5, 5, 5, 3, 3, 3, 1, 1, 5, 4, 4, 7], 
[7, 5, 5, 5, 5, 1, 1, 1, 5, 5, 5, 5, 5, 5, 5, 3, 3, 3, 5, 1, 1, 4, 4, 4, 7], 
[7, 5, 5, 4, 5, 5, 1, 5, 5, 5, 5, 5, 4, 4, 3, 3, 3, 5, 5, 1, 1, 5, 4, 4, 7], 
[7, 5, 5, 5, 5, 5, 4, 5, 5, 5, 5, 4, 4, 3, 3, 3, 3, 5, 4, 4, 5, 4, 4, 4, 7], 
[7, 5, 5, 5, 5, 5, 5, 5, 5, 5, 4, 3, 3, 3, 3, 3, 5, 5, 4, 5, 4, 5, 5, 4, 7], 
[7, 5, 5, 5, 5, 5, 5, 5, 5, 5, 3, 3, 3, 3, 3, 5, 5, 4, 4, 5, 4, 5, 4, 5, 7], 
[7, 7, 7, 7, 7, 7, 7, 7, 7, 7, 7, 7, 7, 7, 7, 7, 7, 7, 7, 7, 7, 7, 7, 7, 7] ],[]]